5 5 5 5 5 5 5 5 5 5 5 5 5 5 5 5 5 5 5 5
5 0 0 0 0 0 0 0 0 0 0 0 0 0 0 0 0 0 0 5
5 0 0 0 8 8 8 0 0 0 0 0 0 0 0 0 0 0 0 5
5 0 0 8 0 0 0 8 8 0 5 5 0 5 5 5 0 0 8 5
5 5 0 0 0 0 0 0 0 0 0 0 0 5 0 0 0 8 8 5
5 5 5 5 0 8 8 0 0 0 0 0 0 5 0 5 5 5 5 5
0 0 0 0 0 0 0 8 5 5 5 0 0 5 0 0 0 0 0 5
0 0 0 8 0 0 0 0 0 0 0 0 5 5 0 0 8 0 0 5
0 0 8 8 0 0 0 0 0 0 0 5 6 5 6 0 8 8 0 0
5 5 5 5 5 5 5 5 5 5 5 5 5 5 5 5 5 5 5 5